BBBBBBBBBBBBBBBBBBBB
BB   BBBBBBBBBBBBBBB
BB   BBBBBBBBBBBBBBB
BB         BBBBBBBBB
BBBBBBBBBB BBBBBBBBB
BBBBBBBBBB BBBBBBBBB
BBBBBBBB   BBBBBBBBB
BBBBBBB    BBBBBBBBB
BBBB       BBBBBBBBB
BBBB  BBBBBBBBBBBBBB
BBBB  BBBBBBBBBBBBBB
BBBB   BBBBBBBBBBBBB
BBBB     BBBBBBBBBBB
BBBBBBB  BBBBBBBBBBB
BBBBBBB  BBBBBBBBBBB
B        BBBBBBBBBBB
BB S BBBBBBBBBBBBBBB
BBBBBBBBBBBBBBBBBBBB
BBBBBBBBBBBBBBBBBBBB
BBBBBBBBBBBBBBBBBBBB