BBBBBBBBBBBBBBBBBBBB
B                  B
BBBBBB BBBBBBBBBBBBB
BBBBBB BBB      BBBB
BBBBBB BBB BBBB    B
BBBBBB BBB BBBBBBB B
BBBBBB           B B
B    B BBBBBBBBBBB B
B BBBBBBB B B B BB B
B BBBB             B
B  BBB BBBBBBBBBBBBB
BB     BBBBBBBBBBBBB
BBBBBB BBBBBBBBBBBBB
BB BBB             B
BB BBBBBBBBB BBBBB B
B                B B
BBBBBBB BBBBBBBBBB B
BB BBBB BBBBBBBBBB B
BB                 B
BBBBBBBBBBBBBBBBBBBB