BBBBBBBB
B BBBBBB
B B   BB
B BBB BB
B     BB
B BBB BB
BSBBB BB
BBBBBBBB
